0 0 0 0 0 0 0 0 0 0 0 0 0 0 0 0 0 0 0 0 0 0 0 0 0 0 0 0 0 0 0 0 0 0 0 0 0 0 0 0 0 0
0 1 1 1 1 1 1 1 1 1 1 1 1 1 1 0 1 1 1 1 1 1 1 1 1 1 1 1 0 1 1 3 3 1 1 1 1 1 1 1 1 0
0 1 1 6 6 6 3 1 3 6 6 6 6 6 1 4 1 1 1 1 1 1 1 1 1 1 1 1 0 1 1 3 3 1 1 0 6 6 6 1 1 0
0 1 1 6 6 6 1 1 3 6 6 6 6 6 3 0 1 1 1 1 1 1 1 1 1 1 1 1 0 1 1 3 3 1 1 0 6 6 6 1 1 0
0 1 1 6 6 6 1 3 3 6 6 6 6 6 3 0 1 1 1 1 6 6 6 1 1 1 1 1 0 1 1 3 3 1 1 0 6 6 6 1 1 0
0 1 1 6 6 6 1 -2 1 1 1 1 1 1 3 0 3 3 3 1 6 6 6 1 1 1 1 1 0 1 1 3 3 1 1 0 6 6 6 1 1 0
0 1 1 6 6 6 1 1 1 6 6 1 1 1 1 0 3 3 3 1 6 6 6 1 1 1 1 1 0 3 1 1 1 1 1 0 1 1 1 1 -1 0
0 1 1 1 1 1 1 1 1 6 6 1 1 1 1 0 3 3 3 1 6 6 6 1 1 1 1 1 0 3 1 1 1 1 1 0 0 0 0 0 0 0
0 1 1 1 1 1 1 1 1 1 1 1 1 1 1 0 3 3 3 1 6 6 6 1 1 1 1 1 0 6 6 6 6 6 1 1 1 1 1 1 1 0
0 0 0 0 0 0 0 0 0 0 0 0 0 0 0 0 3 3 3 1 6 6 6 1 1 1 1 1 0 6 6 6 6 6 1 1 1 1 1 1 1 0
0 1 1 1 1 1 1 1 1 1 1 1 1 1 1 1 3 3 3 1 6 6 6 1 1 1 1 1 0 6 6 6 6 6 1 1 1 1 1 1 1 0
0 1 1 1 1 1 1 1 1 1 1 1 1 1 1 1 1 1 1 1 1 1 1 1 1 1 1 1 0 1 1 1 1 1 1 1 1 1 1 1 1 0
0 1 1 1 1 6 6 6 6 6 6 6 6 6 6 6 1 1 1 3 3 3 3 3 3 1 1 1 0 0 0 4 0 0 0 0 0 0 0 0 0 0
0 1 1 1 1 6 6 6 6 6 6 6 6 6 6 6 1 1 1 1 1 1 3 3 3 3 1 1 1 1 1 1 1 1 1 1 1 1 1 1 1 0
0 0 0 4 0 0 0 0 0 0 0 0 0 0 0 0 0 0 0 0 1 1 1 1 1 3 3 3 3 3 3 3 1 1 1 1 1 1 1 1 1 0
0 1 1 1 1 3 3 3 1 1 1 1 1 1 1 1 1 1 1 0 1 1 1 1 1 1 1 1 1 1 1 1 1 1 1 1 1 1 1 1 1 0
0 1 1 1 1 1 1 1 1 1 3 3 3 3 3 1 1 1 1 0 6 6 6 6 0 0 0 0 0 0 0 0 0 0 0 0 0 0 0 0 4 0
0 1 1 1 6 6 6 6 6 6 6 6 6 6 6 6 6 1 1 0 6 6 6 6 0 3 1 1 1 1 1 1 1 1 1 1 1 -4 0 1 1 0
0 1 1 1 3 3 3 3 1 1 1 1 1 3 3 1 1 1 1 0 6 6 6 6 0 1 3 1 1 1 1 1 1 1 1 1 1 0 6 1 1 0
0 1 1 1 3 3 3 3 1 1 1 1 1 3 3 1 1 1 1 0 1 1 1 1 0 1 1 3 3 3 1 1 1 1 1 1 0 6 6 1 1 0
0 0 0 0 0 0 0 0 0 1 -3 1 1 3 3 1 1 1 1 0 1 1 1 1 0 1 1 3 3 3 1 1 1 1 1 0 6 6 6 1 1 0
0 1 1 1 1 1 1 1 0 1 1 1 1 3 3 1 1 1 1 0 1 1 1 1 0 1 1 3 3 3 1 1 1 1 0 6 6 6 1 1 1 0
0 1 1 1 1 1 1 1 0 1 1 1 1 1 1 1 1 1 1 0 1 1 1 1 0 1 1 3 3 3 1 1 1 0 6 6 6 1 1 1 1 0
0 1 1 1 1 1 1 1 0 1 1 1 1 1 1 1 1 1 1 0 1 1 1 1 4 1 1 3 3 3 1 1 0 6 6 6 6 1 1 1 1 0
0 1 1 1 1 1 1 1 0 0 0 0 0 0 0 0 0 0 0 0 1 1 1 1 0 1 1 3 1 1 1 0 6 6 6 6 1 1 1 1 1 0
0 1 1 1 1 1 1 1 1 1 1 1 6 6 6 6 6 1 1 1 1 1 1 1 0 1 1 3 1 1 0 6 6 6 6 6 1 1 1 1 1 0
0 1 3 3 3 3 3 1 1 1 1 1 6 6 6 6 6 1 1 1 1 1 1 1 0 1 1 3 1 1 0 6 6 6 1 1 1 1 1 1 1 0
0 1 3 3 3 3 3 6 6 6 6 6 6 6 6 1 1 1 1 1 1 1 1 1 0 1 1 3 1 1 0 6 6 1 1 1 1 1 1 1 1 0
0 1 3 3 3 3 3 6 6 6 0 0 0 0 0 1 1 1 1 1 1 1 1 1 0 1 1 1 1 1 0 6 6 1 3 3 3 3 1 1 1 0
0 1 1 1 1 1 6 6 1 0 1 1 1 1 0 1 1 1 1 3 1 1 6 1 0 1 1 1 1 1 0 6 6 1 3 3 3 3 1 1 1 0
0 3 3 3 3 1 1 1 0 1 1 -5 1 1 0 1 1 1 1 3 1 1 6 1 0 1 1 1 1 1 0 6 6 1 3 3 3 3 1 1 1 0
0 3 3 3 1 1 0 0 1 1 1 1 1 1 0 1 6 6 6 3 6 6 6 1 0 1 1 1 1 1 0 6 6 1 3 3 3 3 1 1 1 0
0 1 1 1 1 0 1 1 6 6 6 1 1 1 0 1 1 1 1 1 1 1 6 1 0 0 0 0 0 0 0 6 6 1 1 1 1 6 6 0 4 0
0 1 1 1 0 1 1 1 6 6 6 1 1 1 0 6 6 6 6 6 1 1 6 6 6 6 6 6 6 6 6 6 6 1 1 1 6 6 0 1 1 0
0 0 4 0 1 1 1 1 6 6 6 1 1 1 0 1 1 1 1 1 1 1 6 1 1 1 1 1 1 1 1 1 1 1 1 6 6 0 1 1 1 0
0 1 1 1 1 3 3 3 6 6 6 1 1 1 0 3 3 3 1 6 6 6 6 1 1 1 1 1 1 1 1 1 1 6 6 6 0 1 1 1 1 0
0 1 1 1 1 3 3 3 1 1 1 1 1 1 0 3 3 3 1 1 1 1 6 3 3 3 3 1 1 1 1 1 6 6 6 0 1 1 3 3 3 0
0 0 0 0 0 0 0 0 0 0 0 0 0 0 0 3 3 3 1 1 1 1 6 1 1 3 1 1 6 6 6 6 6 6 0 1 1 1 3 3 3 0
0 1 1 1 1 1 1 1 1 1 1 1 1 1 1 3 3 3 1 1 1 1 6 1 1 3 1 1 6 6 6 6 6 0 1 1 1 1 3 3 3 0
0 1 1 1 1 1 1 1 1 1 1 1 1 1 1 3 3 3 1 1 1 1 1 1 1 3 1 1 6 6 6 6 0 1 1 1 1 1 1 1 1 0
0 1 1 1 1 1 1 1 1 1 1 1 1 1 1 1 1 1 1 1 1 1 1 1 1 1 1 1 6 6 6 6 4 1 1 1 1 1 1 1 1 0
0 0 0 0 0 0 0 0 0 0 0 0 0 0 0 0 0 0 0 0 0 0 0 0 0 0 0 0 0 0 0 0 0 0 0 0 0 0 0 0 4 0
